# MAPA - The Ashen Realm (Sosaria Overworld, 64x64)
# Legend: ~=Brine .=Ash "=Thorns T=Mycelium ^=Spires D=Abyss #=Haven @=Bastion
#         !=Null Field *=Ichor 0=Rift _=Floor $=Chest h=Horse S=Ship
# The Ashen Realm: A corrupted overworld with brine seas, ash plains,
# fungal forests, and crystal spires. Havens are scattered refuges.
~~~~~~~~~~~~~~~~~~~~~~~~~~~~~~~~~~~~~~~~~~~~~~~~~~~~~~~~~~~~~~~~
~~~~~~~~~~~~~~~~~~~~~~~~~~~~~~~~~~~~~~~~~~~~~~~~~~~~~~~~~~~~~~~~
~~~~~~~~~~~~~~~~~~~~...........~~~~~~~~~~~~~~~~~~~~~~~~~~~~~~~~~
~~~~~~~~~~~~~~~~~~.....".."......~~~~~~~~~~~~~~~~~~~~~~~~~~~~~~~
~~~~~~~~~~~~~~~~~..."T..T..T"....~~~~~~~~~~~~~~~~~~~~~~~~~~~~~~~
~~~~~~~~~~~~~~~~...."TT..TT".....~~~~~~~~~~~~~~~~~~~~~~~~~~~~~~~
~~~~~~~~~~~~~~~.....""......."....~~~~~~~~~~~~~~~~~~~~~~~~~~~~~~
~~~~~~~~~~~~~~......".........".................................
~~~~~~~~~~~~~.......".........".................................
~~~~~~~~~~~~........"...D....."....^^^^^........................
~~~~~~~~~~~.........""......."....^^^^^^........................
~~~~~~~~~~...........""""""""....^^^^^^^........................
~~~~~~~~~...............................^^^^^^..................
~~~~~~~~.................................^^^^^..................
~~~~~~~...........^^.^^.....................^^^.................
~~~~~~............^^^^..........#............................~~~
~~~~~.............^^^...................................~~~~.~~~
~~~~..............^^...............................~~~~~....~~~~
~~~~.............................................~~~~~~...~~~~~~
~~~~.............@.......#.............."".......~~~~~~..~~~~~~~
~~~~............................................................
~~~~.......#...............0..........."""".........~~..~~~~~~~~
~~~~..........................................................~~
~~~~.........................................""..............~~~
~~~~............."""""..........#..........."""T""...........~~~
~~~~............."T"T"......................."TTTT"..........~~~
~~~~.............."T"........................"TT""..........~~~~
~~~~...............""".......D............................~~~~~~
~~~~...........*...................................*....~~~~~~~~
~~~~..........***.......................................~~~~~~~~
~~~~...........*...........0..........^^............~~~~~~~~~~~~
~~~~..................#................^^...........~~~~~~~~~~~~
~~~~...........D............"".........^^^.........~~~~~~~~~~~~~
~~~~......................"""""..........^^........~~~~~~~~~~~~~
~~~~....................""T"T""..........^^........~~~~~~~~~~~~~
~~~~...................."T"T"T"..................~.~~~~~~~~~~~~~
~~~~....................."""T"""..........D......~~~~~~~~~~~~~~~
~~~~.....................""""""..........#......~~~~~~~~~~~~~~~~
~~~~...........................................~~~~~~~~~~~~~~~~~
~~~~..........D........0..........^^...........~~~~~~~~~~~~~~~~~
~~~~..........................^^^^.............~~~~~~~~~~~~~~~~~
~~~~.............#..........^^^^^^.............~~~~~~~~~~~~~~~~~
~~~~........................^^^^^^^............~~~~~~~~~~~~~~~~~
~~~~.......!!!!..........^^^^^^^^.........~~~~~~~~~~~~~~~~~~~~~~
~~~~.......!..!.........^^^^^^^...........~~~~~~~~~~~~~~~~~~~~~~
~~~~.......!..!.........^^^^^^............~~~~~~~~~~~~~~~~~~~~~~
~~~~.......!!!!..........^^^^.............~~~~~~~~~~~~~~~~~~~~~~
~~~~...........................*..........~~~~~~~~~~~~~~~~~~~~~~
~~~~..........................***.........~~~~~~~~~~~~~~~~~~~~~~
~~~~..........................*...........~~~~~~~~~~~~~~~~~~~~~~
~~~~..........D..........#................~~~~~~~~~~~~~~~~~~~~~~
~~~~...........0...........................~~~~~~~~~~~~~~~~~~~~~
~~~~..........................................~~~~~~~~~~~~~~~~~~
~~~~.............................................~~~~~~~~~~~~~~~
~~~~.............."""""..........D..................~~~~~~~~~~~.
~~~~............."""T""".........................~~~~~~~~~~~~~..
~~~~............."TTT""..........................~~~~~~~~.......
~~~~.............."""".............................~~~~~........
~~~~...............""...............................~~~.........
~~~~.....................................................~~~~~~~
~~~~...............................................~~~~~~~~~~...
~~~~...............................................~~~~~~~~~~...
~~~~~~~~~~~~~~~~~~~~~~~~~~~~~~~~~~~~~~~~~~~~~~~~~~~~~~~~~~~~~~~~
~~~~~~~~~~~~~~~~~~~~~~~~~~~~~~~~~~~~~~~~~~~~~~~~~~~~~~~~~~~~~~~~
